25;violet;
########OOOOOOO####OO####
#######OO......O##O.*O###
######OO....F...OO..O####
######O.........O..######
######O..########.#######
#####OO..#**##****#######
#####O...#*#..#***#######
##OOO#...##..#****#######
##OOO#...#..#*****#######
##OOO#..#..#******#######
##OOO#.#..#####.#########
#OOOO#.#.#........#######
#OOOO#............#######
#OFOO#..........F.#######
#OOOOP............#######
#OOOO#............#######
#OOOO#............#######
#OOOO#............#######
##OOO#............#######
#####O....OOOOO...#######
#####O....O##O...O#######
#####O....O##O...O#######
#####O.F..O##O...O#######
#####O....O##OOOOO#######
######OOOOO##############