50;violet;
##################################################
##################################################
OOOOOOOOOOOOOOOOOOOOOOOOOOOOOOOOOOOOOOOOOOOOOOOOOO
###*........#####.*.#####.#########.##*........###
###.############..#..####.########..##.###########
###.###########..###..###.########..##.###########
###.##########..#####..##.#######..###.###########
###.##########.#######.##.#######.####.###########
###.##########.#######.##.######..####.###########
###.##########.#######.##.######.#####.###########
OOO.##########.#######.##.#####..#####.OOOOOOOOOOO
###.##########.#######.##.#####.######.###########
###.OOOOOOOOOO.#######.##.####..######.###########
###.##########.#######.##.####.#######.###########
###.##########.#######.##.###..#######*###########
###.##########.#######.##.###.########.###########
###.##########.#######.##.##..########.###########
###.##########.#######.##.##.#########.###########
###.##########.#######.##.#..#########.###########
###.##########.#######.##...##########.###########
###.##########.#######.##..OFOOOOOOOOO.###########
###.##########.#######.##.##O#########.###########
OOO....P....##.........##.#FFF########.........OOO
#######O###.##.#######.##.############.###########
#######O###.##.#######.##..###########.###########
##......###.##.#######.##...##########.###########
OO.####.###.##.#######.##.#..#########.###.####.OO
##.####.###.##.#######.##.##.#########.###.####.##
##......###.##.#######.##.##..########.###.####.##
##.########.##.#######.##.###.########.###.####.##
##.########.##.#######.##.###..#######.###.####.##
##.########.##.#######.##.####.#######.###.####.##
##.########.##.#######.##.####..######.###.####.##
##.OOO#####.##.#######.##.#####.######.###......##
#####O#####.##.#######.##.#####..#####.###O#######
####..#####.##.#######.##.######.#####.###.#######
###....####.##.#######.##.######*.####.###.#######
##..##..###.##.#######.##.#######.####.###.#######
##..##..###.##.#######.##.#######..###.###.#######
##......###.##.#######.##.########.###.###.#######
##.####.###.##.#######.##.########..##.###.#######
##.####.###.##.#######.##.#########.##.###.#######
##.####.###.##.#######.##.#########.OO.###.#######
##.####.OOO.##.#######.##.#########.##.###......##
##O########.##.#######.##.#########.##.########O##
##O########.##.#######.##.#########.##.########O##
##O*........##.#######.##.#########.##.........O##
OOOOOOOOOOOOOOOOOOOOOOOOOOOOOOOOOOOOOOOOOOOOOOOOOO
##################################################
##################################################